$13
#############
#     #     #
#     #     #
#           #
#     #     #
#     #     #
## ####     #
#     ###g###
#     #     #
#     #     #
#           #
#     #     #
#############
