$11
###########
#         #
#    #    #
#    #    #
#    # uu #
#  0 # uu #
### ## uu #
#dddu# uu #
#dddu# uu #
#uu      g#
###########
