$10
##########
#0ssssssg#
# jjjjjj #
# ssssss #
#  ssss  #
#   ss   #
#        #
#        #
#        #
##########
